11111111111111111111111111
10100000011011000001000001
1010000001111100000100E001
101000P0010101000001000001
100C0100000000000100001001
11111111111111111111111111